{
    "width" : 8,
    "depth" : 10,
 
    "sunlight" : [ -1, 1, 0 ],
 
    "altitude" : [
        0, 0, 0, 0, 0, 0, 0, 0,
        0, 1, 1, 1, 1, 1, 1, 0,
        0, 1, 2, 2, 2, 2, 1, 0,
        0, 1, 2, 3, 3, 2, 1, 0,             
        0, 1, 2, 3, 3, 2, 1, 0,
        0, 1, 2, 2, 2, 2, 1, 0,
        0, 1, 1, 1, 1, 1, 1, 0,
		0, 0, 0, 0, 0, 0, 0, 0,
		0, 0, 0, 0, 0, 0, 0, 0,
		0, 0, 0, 0, 0, 0, 0, 0,      
    ],

	"roads" : [
		{
			"width" : 1,
			"spine": [
				3.5, 0,
				3.5, 2,
				3.5, 4,
				3.5, 8
			]
		}
	]

}